50 24
3333333333333333333333333333333333333333333333
4000000030030003000000000300030003000300030023
3333330000030000000000030003000300030003000333
3000000030000333333033333333333333333333333333
3033333330030000033030000000000000000002300003
3033333330030000003303000003303333333333303003
3032000000030000300300033330030000000000003101
3000030000030000000300030000000030000000031001
3333333333333333300000000000030000000000310001
1111111111111111133333333333333333333333100001
1111111111111111111111111111111111111111000001
1000000000000000001111100000000000000000000001
1000000000000000001111100000001100000011110001
1000000000088858881111100000001100000011110001
1000005858500000051111100000000000000011110001
1000080000050000085885810000000000011111110001
1000500000008000000000511000000000111160000001
1008400000000000000000810100000000011111110001
1000800000005000000000510010000000000011110001
1000050000080000000000810010000000000011110001
1000008888500000000000811110000000000011110001
1000000008888858888580000000000000000000070001
1000001000010000100008100001000010000100171001
1111111111111111111111111111111111111111111111
