10 10
1111111111
1000000011
1011011011
1001011001
1100000011
1110110001
1110110001
1110110001
1100000011
1111111111
