32 127
11111111111111111111111111111111
10000000000000000000000000000001
10000000000000000000000000000001
10000000000000000000000000000001
10000000000000000000000000000001
10000000000000000000000000000001
10000000000000011000000000000001
10000000000000011000000000000001
10000000000000011000000000000001
10000000000000111100000000000001
10000000000000100100000000000001
10000000000000100100000000000001
10000000000001101110000000000001
10000000000001000010000000000001
10000000000001000010000000000001
10000000000011100111000000000001
10000000000011000011000000000001
10000000000001000010000000000001
10000000000011100111000000000001
10000000000010000001000000000001
10000000000110000001100000000001
10000000000010100101000000000001
10000000000110000001100000000001
10000000000100000000100000000001
10000000011100000000111000000001
10000000000100000000100000000001
10000000011100000000111000000001
10000000000110000001100000000001
10000000000010100101000000000001
10000000000110000001100000000001
10000000001100000000110000000001
10000000011000000000011000000001
10000000110000000000001100000001
10000001100000000000000110000001
10000011000011000011000011000001
10000010000001000010000001000001
10000010000001000010000001000001
10000010000001000010000001000001
10000011000011000011000011000001
10000001000000000000000010000001
10000001000000000000000010000001
10000011001001000010010011000001
10000010001001000010010001000001
10000010000000000000000001000001
10000110000000000000000001100001
10000100010000000000001000100001
10000100010001000010001000100001
10000100011001000010011000100001
10001100000000000000000000110001
10001000000000000000000000010001
10001000100000000000000100010001
10001000100011000011000100010001
10001000110011000011001100010001
10001000000000000000000000010001
10001100000000000000000000110001
10000110000000000000000001100001
10000011100000000000000111000001
10000000100111100111100100000001
10000000100000000000000100000001
10000000100000000000000100000001
10000000100000000000000100000001
10000001100111000011100110000001
10000011000100000000100011000001
10000110000000000000000001100001
10000100000000000000000000100001
10000100000000000000000000100001
10000100000100000000100000100001
10000100000100000000100000100001
10000100000100000000100000100001
10000100000000000000000000100001
10000100000000000000000000100001
10000110000000000000000001100001
10000011000100000000100011000001
10000001100111000011100110000001
10000000100000000000000100000001
10000000100000000000000100000001
10000000100000000000000100000001
10000001100111000011100110000001
10000001000101000010100010000001
10000001000101000010100010000001
10000001000101000010100010000001
10000001100111000011100110000001
10000000100000000000000100000001
10000000100000000000000100000001
10000001100111000011100110000001
10000001000110000001100010000001
10000001100111000011100110000001
10000000100000000000000100000001
10000000100000000000000100000001
10000001100111000011100110000001
10000001000110000001100010000001
10000001100111000011100110000001
10000000100000000000000100000001
10000000100000000000000100000001
10000001100111000011100110000001
10000000000110000001100010000001
10000001100111000011100110000001
10000000100000000000000100000001
10000000100000000000000100000001
10000000100000000000000100000001
10000000111111100111111100000001
10000000011110000001111000000001
10000000011110000001111000000001
10000000111111100111111100000001
10000000101010100101010100000001
10000000100000100100000100000001
10000011101010100101010111000001
10000100000000000000000000100001
10000100101010100101010100100001
10000111101110100101110111100001
10000000101010100101010100000001
10000000100000100100000100000001
10000000101010100101010100000001
10000000100000100100000100000001
10000000101010100101010100000001
10000001100000100100000110000001
10000001101010100101010110000001
10000011000000100100000011000001
10000110000000100100000001100001
10000111111111111111111111100001
10000000001100011000110000000001
10000000011110000001111000000001
10000000000000000000000000000001
10000000000000000000000000000001
10000000000000000000000000000001
10000000000000000000000000000001
11111111111111111111111111111111
